R 1000 1000
C 51,196,255
F 112, 112, 112

NO ./textures/wood.xpm
EA ./textures/wall2.xpm
WE ./textures/stone.xpm
SO ./textures/wood.xpm
S ./textures/ss1.xpm
S5 ./textures/c4onground.xpm
S3 ./textures/sprite.xpm
S4 ./textures/lego.xpm


          111
          1S1
          101
          151
         11711
  111111110001111111    111111111111
  100030000000005001    100003002001
  100000000000040001    102000000001
  1500000000000000011111100000000201
  1000002000000040000000000000000061
  1000000000000200000000000000000201
  1000000000000000011111100000000001
  100000000000000001    100000000001
  100040000000000001    100200502031
  100000000000000001    171111111111
  100300000000000001    101
  111111116111111111    101
         101000000011111101
         101000200060000401
         100000200011111111
         11111111111